{
	"name": "Test1",
	"owner": "Pepe",
	"matrix": [
		[0,0,0,0,0,0,0],
		[1,0,0,0,0,0,0],
		[1,0,0,0,0,0,0],
		[1,0,0,0,0,0,0],
		[1,0,0,0,0,0,0],
		[1,0,0,0,0,0,0],
		[1,0,0,0,0,0,0],
		[1,0,0,0,0,0,0],
		[1,0,0,0,1,0,0],
		[1,0,0,0,1,0,0],
		[1,0,0,0,1,0,0],
		[0,0,0,0,0,0,0],
		[0,0,1,0,0,0,0],
		[0,0,0,0,0,0,0]
	]
}